G G G G G G G G G G G G G G G G G G G G G G G G S
G G G G G G G G G G G G G G G G G G G G S G G G G
G G G G G G G S S S S G G G G G G G G G S G G G G
G G G G G G G G G G G G G G G G G G G G G G G G G
G G G G G G G G G G G G G G G G G G G G G G G G S
G G G G G G G G G G G G G G G G G G G G S G G G G
G G G G G G G G G G G G G G G G G G G G S G G G G
G G G G G G G G G G G G G G G G G G G G S G G G G
G G G G G G G G G G G G G G G G G G G G S G G G G
G G G G G G G G G G G G G G G G G G G G S G G G G
G G G G G G G G G G G G G G G G G G G G S G G G G
G G G G G G G G G G G G S S S G G G G G S G G G G
G G G G G G G G G G G G S S S G G G G G S G G G G
G G G G G G G G G G G G S S S G G G G G S G G G G
G G G G G G G G G G G G G G G G G G G G S G G G G
G G G G G G G G G G G G G G G G G G G G S G G G G
G G G G G G G G G G G G G G G G G G G G S G G G G
G G G G G G G G G G G G G G G G G G G G S G G G G
G G G G G G G G G G G G G G G G G G G G S G G S G
G G G G G G G G G G G G G G G G G G G G S S S S G