WWWWWWWWWWWWWWWWWWWWWWW
WP....................W
W.....................W
W.....................W
W.....................W
W.....................W
W.....................W
W.....................W
W.....................W
W.....................W
W.....................W
W.....................W
WWWWWWWWWWWWWWWWWWWWWWW