WWWWWWWWWWWWWWWWWWWWWWW
WP....................W
W.....................W
W.....................W
W.....................W
W.....................W
W.....................W
W.....................W
W.....................W
W.....................W
W.....................W
W.............D.......W
WW..WWTTWWWWWWWWWWWWWWW